16 11
########I#######
#         ## # #
# ## # #       #
# ## #### ### ##
####   #   #   #
###### #########
#      #   #   E
##    #        #
## #### ########
##             #
################
